
NO ./textures_xpm/Bushes.xpm
SO ./textures_xpm/naturalbricks.xpm
WE ./textures_xpm/redbrick.xpm
EA ./textures_xpm/naturalbricks_hd_dark.XPM

F 173,190,209
C 166,166,166

111111111111111111111111
100000000000000000000001
100000N00000000000000001
100000000000000000000001  111111
100000111100000101010001  100000
100000100010000000000001  111111
100000100010000100010001
100000100010000000000001
100000110110000101010001
100000000000000000000001
100000000000000000000001
100000000000000000000001
100000000000000000000001
100000000000000000000001
100000000000000000000001
100000000000000000000001
111111111000000000000001
110100001000000000000001
110000101000000000000001
110100001000000000000001
110111111000000000000001
110000000000000000000001
111111111000000000000001
111111111111111111111110
