NO ./textures/eagle.xpm
SO ./textures/greystone.xpm
WE ./textures/redbrick.xpm
EA ./textures/bluestone.xpm

F 59,59,59
C 100,100,100

11111111111111111111111111111111111
100011110000000000000000000000000S1
10001111000000000000000000000000001111
10001111000000000000000001110000000001
10001111000000000000000001110000000001111111111
10000011110011111000111111110000000000000000001
10000011110011111000111111110000000000000000001
10000011110011111000111110000000000000000001111
10000011110011111000111110000000000000000001
10000000011110001111110000000000000000011111
1000000001111000111111000000000000000001
1000000001111000111111000000000000000001
1000000001111000111111000000000000000001
1000000000000000000000000000001111111111
1000000000000000000000000000001
1111111111111111111111111111111