NO ./textures/eagle.xpm

SO ./textures/greystone.xpm

WE ./textures/redbrick.xpm

EA ./textures/bluestone.xpm

F 173,190,209

C 166,166,166






11111111111111111111111111111111111
100011110000000000000000000000000W1
100011110000000000000000000000000011111
10000000011110001111110000000000000000011111
1000000001111000111111000000000000000001
1000000001111000111111000000000000000001
1000000001111000111111000000000000000001
1000000000000000000000000000001111111111
1000000000000000000000000000001
1111111111111111111111111111111

